                                                                                 G
              XXXXXXXXXXXXXXXXXXXXXXXX                                           G
              X                      X                                           G
       P      XXXXXXXXXXXXXXXXXXXXXXXX                                           G
                                                                                 G
                                                                                 G
   X           X                                                                 G
XXXXXXXXXXXXXXXXXXXXXXXXXXXXXXXXXXXXXXXXXXXX    XXXXXXXXXXXXXXX      XXXXXXXXXXXXX