                                                                                 G
              XXXXXXXXXXXXXXXXXXXXXXXX                                           G
              X                      X                                           G
   *   O      XXXXXXXXXXXXXXXXXXXXXXXX                                           G
   *                                                                             G
   *                                                                             G
   X           X              @      X                                           G
XXXXXXXXXXXXXXXXXXXXXXXXXXXXXXXXXXXXXXXXXXXX    XXXXXXXXXXXXXXX      XXXXXXXXXXXXX